NO pics2/wood.xpm 
SO pics2/grey.xpm
S pics2/barrel.xpm   
C 0200,0, 160

EA pics2/mosy.xpm
F       0150, 100 , 22   
 R 1600 900
  WE pics2/red.xpm
1111111111111111111111111111111111111111
1111111111111111111111111001111111111001
1000000000000000000000000000000000000001
1000000000000000000000000000000000000001
1001111111111100111111111111111111111111
1000000000000000000000000000000000000001
1000000000000000000000000000000000000001
1111111111111111111111111001111111111001
1000000000000000000000000000000000000001
1000000000000000000000000000000000000001
1001111111111100111111111111111111111111
1000000000000000000000000000000000000001
1000000000000000000000000000000000000001
1111111111111111111111111001111111111001
1000000000000000000000000000000000000001
1000000000000000000000000000000000000001
1001111111111100111111111111111111111111
1000000000000000000000000000000000000001
1000000000000000000000000000000000000001
1111111111111111111111111001111111111001
1000000000000000020000000000000000000001
1000000000000000000000000000000000000001
1001111111111100111111111111111111111111
1000000000000000000000000000000000000001
1000000000000000000000000000200000000001
1100000000000000000000000000000000N00001
1000000000000000000000000000200000000001
1000000000000000000000000000200000000001
1111111111111111111111111111111111111111
 
        1111111111111111111111111
        1000000011000000000000001
        1011000001110000002000001
        1001000000000000200020001
111111111011000001110000000000001
100000000011000001110111110111111
11110111111111011100000010001
11110111111111011101010010001
11000000110101011100000010001
10002000000020001100000010001
10000000000000000001010010001
11000001110101011111011110001
11110111 1110101 101111010001
11111111 1111111 111111111111 