NO pics2/wood.xpm 
SO pics2/grey.xpm
S pics2/barrel.xpm
C 200,0, 160

EA pics2/mosy.xpm
F 150, 100 ,1
  R 1920 1080
  WE pics2/red.xpm

        1111111111111111111111111
        1000000011000222000000021
        1011000001110020000S00001
        1001000000000000022200001
111111111011000001110000020000021
100000000011000001110111010111111
11110111111111011100000010001
11110111111111011101010010001
11000000110101011100000010001
10002000000020001100000010001
10000000000000000001010010001
11000001110101011111011110001
11110111 1110101 101111010001
11111111 1111111 111111111111